  111111111111111111111111
  1P0111010000000000111111
  100000000000111010000001
  1001E0001000010000000011
  100000001110110000000011
  100000000000000000000C11
  111111111111111111111111
