  111111111111
  1P0111011111
  1001E0100011
  100001100011
  1C00000C0C11
  111111111111
